{
  "maps": [
    {
      "mapId": "alpha-run",
      "name": "Alpha Run",
      "mazeRows": [
        "#######...............###",
        "#.....#.###.######....#.#",
        "..#.###.###.#......##.#.#",
        "#.#.....###.#.......#...#",
        "#.#########.#####.#.###.#",
        "#.#.......#...#...#...#.#",
        "#.#.#####.###.#.#.#.#.#.#",
        "#...#...#.#...#.#.#.#...#",
        "#.#.#.###.#.###.###.#.###",
        "#.....#.....#...#...#...#",
        "#####.#.#.#.#.#######.#.#",
        "#.....#.#.#.#.#.....#.#.#",
        "#.###.#.#.###.#.###.#.#.#",
        "#...#.......#.#.....#.#.#",
        "###.#.#####.#.#.#.#######",
        "#...#...#.....#.#.#.#...#",
        "#.#.#.#.#.#####.#.#.#.###",
        "#.#...#.#.#.....#...#...#",
        "#.#####.#.#.#.###.#.#.#.#",
        "#.....#...#.#.........#.#",
        "#.#########.#.###.#.###.#",
        "#.#.......#.#...#.#.#...#",
        "#.#.#.#####.###.###.###.#",
        "#...#.........#.......#G#",
        "#########################"
      ],
      "updatedAt": "2026-03-26T15:09:56.674Z"
    },
    {
      "mapId": "beta-dash",
      "name": "Beta Dash",
      "mazeRows": [
        "#########################",
        "#...#...........#.......#",
        "..#...#.#.###.#.###.#.#.#",
        "#.#.#...#...........#...#",
        "#.#.#######.####.####.###",
        "#.#.#...#...........#.#.#",
        "#.#.#.###########.#.#.#.#",
        "#...#.#.........#.#...#.#",
        "#.###.#.###...###.#.###.#",
        "#.#.#...#...#.#...#.....#",
        "#...#.###.###.###.#.###.#",
        "#.#.#.....#.....#...#...#",
        "#.#.#.#.#############.###",
        "#.#...#...#...#.......#.#",
        "#.###.###.#.#.#.#######.#",
        "#.......#...#.#.......#.#",
        "#.#####.#.###.####.##.#.#",
        "#.....#.#...#.#.....#...#",
        "#.###.#.###.#.#.#.#####.#",
        "#.#...#...#.#.#.#.#.....#",
        "#.#######.###.#.###.#####",
        "#.#.....#...#.#.........#",
        "#.#.#######.#.#.#.#####.#",
        "#.............#.#......G#",
        "#########################"
      ],
      "updatedAt": "2026-03-26T15:10:36.668Z"
    },
    {
      "mapId": "gamma-knot",
      "name": "Gamma Knot",
      "mazeRows": [
        "###############...#######",
        "#.....#.........#.......#",
        "..###.#####.###.#######.#",
        "#...#.......#.#.#.......#",
        "#.#.#########.#.#######.#",
        "#.#.#.........#.#.#.....#",
        "#.#.#.#########.#...#####",
        "#.#...#.#.......#.#...#..",
        "#.#####...#######...#.#..",
        "#.#.....#...#...#...#.#..",
        "#.#.#.#####.#.#.#####.#..",
        "#.#.#...#...#.#.......#.#",
        "#.###.###.#.#.#######.#.#",
        "#.#.....#.#.#.....#.....#",
        "#.#.###.#.#.#####.#######",
        "#.#...#.#.#.#.........#.#",
        "#.#.#.#.#.#.#.#######...#",
        "#.....#.#...#.#.....#...#",
        "###.###.###.###.###.###.#",
        "#.....#.#.#.......#...#.#",
        "#.#.###.#.#.###########.#",
        "#.#...#...#...#.........#",
        "#.###.###.###.#.#########",
        "#.........#...#........G#",
        "#########################"
      ],
      "updatedAt": "2026-03-26T15:18:00.152Z"
    },
    {
      "mapId": "delta-snare",
      "name": "Delta Snare",
      "mazeRows": [
        "#########################",
        "#.#...........#...#.....#",
        "..###.#####.#.#.#.###.#.#",
        "#...#...#.#.#...#.#...#.#",
        "###.###.#.#.###.#.#.###.#",
        "#.#.#.....#.....#...#...#",
        "#.#.#####.#########.##.##",
        "#...#.....#...#...#.#...#",
        "#.###.###.#.#.#.#.###.#.#",
        "#.#...#...#.#...#.....#.#",
        "#.#.#.###.#.###########.#",
        "#...#...#.#...#.....#...#",
        "###.###.#.###.#.###.#.#.#",
        "#...#...#.....#...#...#.#",
        "#.###.#####.#.###.#####.#",
        "#.....#.....#...#.....#.#",
        "#######.#######.#####.#.#",
        "#.#.....#.....#.......#.#",
        "#.#.#########.#########.#",
        "#...#.......#.........#.#",
        "#.#########.#.#.#.#.###.#",
        "#...#.....#.#...#.#.#...#",
        "###.#.###.#.#####.#.###.#",
        "#.....#................G#",
        "#########################"
      ],
      "updatedAt": "2026-03-26T15:15:26.009Z"
    },
    {
      "mapId": "epsilon-vault",
      "name": "Epsilon Vault",
      "mazeRows": [
        "#########################",
        "#...#.#.....#.....#...#.#",
        "..#.#.#.#.#.###.#.#.#.#.#",
        "#...#.#.#.#.....#...#...#",
        "#.###.#.#.###############",
        "#.......#.......#.......#",
        "#.#######.#.###.###.#.###",
        "#.#.....#.#...#.....#...#",
        "#.#.#####.#######.#.###.#",
        "#.#...#...#.........#...#",
        "#.###.#.###.#########.###",
        "#.....#.....#...#...#...#",
        "#############.#.###.###.#",
        "#...#.#.......#...#...#.#",
        "#.#.#.#.#####.###.#.#.#.#",
        "#.#...#...#.#.#...#.#...#",
        "#.##.##.#.#.#.#.###.###.#",
        "#.#.....#.#.#.#.#...#...#",
        "#.#.###.#.#.#.#.###.#.###",
        "#...#.#.#.#.###.....#...#",
        "#.###.#.#.#...#########.#",
        "#.....#.#.#.#.....#.....#",
        "#.###...###.#####.#######",
        "#.....#.........#......G#",
        "#########################"
      ],
      "updatedAt": "2026-03-26T15:14:43.472Z"
    },
    {
      "mapId": "eta-gauntlet",
      "name": "Eta Gauntlet",
      "mazeRows": [
        "#########################",
        "#.....#.........#.......#",
        "..###.#########.#.#####.#",
        "#.#...#.......#.#.#.....#",
        "#.#.#.#.#####...#.#.###.#",
        "#.#...#.#.#...#.#.#...#.#",
        "#.#####.#.#.###.#.###.#.#",
        "#.......#...#.......#.#.#",
        "#.#######.###.#########.#",
        "#...#...#.#.....#.......#",
        "#.#...#.#.#.#####.#######",
        "#...#.#...#.#...#...#...#",
        "#.###.#######.#.###.#.#.#",
        "#.....#.....#.#...#...#.#",
        "#.#######.#.#.###.#.###.#",
        "#.#.......#...#...#.#...#",
        "#.#.###########.#####.###",
        "#.#.#...#.....#.#.....#.#",
        "#.#.#.#.#.#.###.#.#.#.#.#",
        "#...#.#...#.#...#...#.#.#",
        "#.###.#####.#.#####.#.#.#",
        "#.#...#.....#.#.....#.#.#",
        "#.#.#########.###.#.#.#.#",
        "#.................#....G#",
        "#########################"
      ],
      "updatedAt": "2026-03-26T15:17:07.189Z"
    }
  ]
}