{
  "maps": [
    {
      "mapId": "alpha-run",
      "name": "Alpha Run",
      "mazeRows": [
        "#######...............###",
        "#.#...#.###.######....#.#",
        "....###.###.#......##.#.#",
        "#.#.....###.#.......#...#",
        "#.#########.#####.#.###.#",
        "#.#.......#...#...#...#.#",
        "#.#.#####.###.#.#.#.#.#.#",
        "#...#...#.#...#.#.#.#...#",
        "#.#.#.###.#.###.###.#.###",
        "#.....#.....#...#...#...#",
        "#####.#.#.#.#.#######.#.#",
        "#.....#.#.#.#.#.....#.#.#",
        "#.###.#.#.###.#.###.#.#.#",
        "#...#.......#.#.....#.#.#",
        "###.#.#####.#.#.#.#######",
        "#...#...#.....#.#.#.#...#",
        "#.#.#.#.#.#####.#.#.#.###",
        "#.#...#.#.#.....#...#...#",
        "#.#####.#.#.#.###.#.#.#.#",
        "#.....#...#.#.........#.#",
        "#.#########.#.###.#.###.#",
        "#.#.......#.#...#.#.#...#",
        "#.#.#.#####.###.###.###.#",
        "#...#.........#.......#G#",
        "#########################"
      ],
      "updatedAt": "2026-03-23T12:57:09.625Z"
    },
    {
      "mapId": "beta-dash",
      "name": "Beta Dash",
      "mazeRows": [
        "#########################",
        "#...#...........#.......#",
        "......#.#.###.#.###.#.#.#",
        "#.#.#...#...........#...#",
        "#.#.#######.####.####.###",
        "#.#.#...#...........#.#.#",
        "#.#.#.###########.#.#.#.#",
        "#...#.#.........#.#...#.#",
        "#.###.#.###...###.#.###.#",
        "#.#.#...#...#.#...#.....#",
        "#...#.###.###.###.#.###.#",
        "#.#.#.....#.....#...#...#",
        "#.#.#.#.#############.###",
        "#.#...#...#...#.......#.#",
        "#.###.###.#.#.#.#######.#",
        "#.......#...#.#.......#.#",
        "#.#####.#.###.####.##.#.#",
        "#.....#.#...#.#.....#...#",
        "#.###.#.###.#.#.#.#####.#",
        "#.#...#...#.#.#.#.#.....#",
        "#.#######.###.#.###.#####",
        "#.#.....#...#.#.........#",
        "#.#.#######.#.#.#.#####.#",
        "#.............#.#......G#",
        "#########################"
      ],
      "updatedAt": "2026-03-23T12:36:17.375Z"
    },
    {
      "mapId": "gamma-knot",
      "name": "Gamma Knot",
      "mazeRows": [
        "###############...#######",
        "#.....#.......#.#.......#",
        "..###.#####.###.#######.#",
        "#...#.......#.#.#.......#",
        "#.#.#########.#.#######.#",
        "#.#.#.........#.#.#.....#",
        "#.#.#.#########.#...#####",
        "#.#...#.#.......#.#...#..",
        "#.#####...#######...#.#..",
        "#.#.....#...#...#...#.#..",
        "#.#.#.#####.#.#.#####.#..",
        "#.#.#...#...#.#.......#.#",
        "#.#######.#.#.#######.#.#",
        "#.#.....#.#.#.....#.....#",
        "#.#.###.#.#.#####.#######",
        "#.#...#.#.#.#.........#.#",
        "#.#.#.#.#.#.#.#######...#",
        "#.....#.#...#.#.....#...#",
        "###.###.###.###.###.###.#",
        "#.....#.#.#.......#...#.#",
        "#.#.###.#.#.###########.#",
        "#.#...#...#...#......G#.#",
        "#.###.###.###.#.#######.#",
        "#...#.........#.........#",
        "#########################"
      ],
      "updatedAt": "2026-03-23T13:45:14.373Z"
    }
  ]
}