{
  "maps": [
    {
      "mapId": "alpha-run",
      "name": "Alpha Run",
      "mazeRows": [
        "#########################",
        "#.#...#...............#.#",
        "....###.#.########.##.#.#",
        "#.#.....#...#.......#...#",
        "#.#########.#####.#.###.#",
        "#.#.......#...#...#...#.#",
        "#.#.#####.###.#.#.#.#.#.#",
        "#...#...#.#...#.#.#.#...#",
        "#.#.#.###.#.###.###.#.###",
        "#.....#.....#...#...#...#",
        "#####.#.#.#.#.#######.#.#",
        "#.....#.#...#.#.....#.#.#",
        "#.###.#.#.###.#.###.#.#.#",
        "#...#.......#.#.....#.#.#",
        "###.#.#####.#.#.#.#######",
        "#...#...#.....#.#.#.#...#",
        "#.#.#.#.#.#####.#.#.#.###",
        "#.#...#.#.#.....#...#...#",
        "#.#####.#.#.#.###.#.#.#.#",
        "#.....#...#.#.........#.#",
        "#.#########.#.###.#.###.#",
        "#.#.......#.#...#.#.#...#",
        "#.#.#.#####.###.###.###.#",
        "#...#.........#.......#G#",
        "#########################"
      ],
      "updatedAt": "2026-03-23T12:35:13.005Z"
    },
    {
      "mapId": "beta-dash",
      "name": "Beta Dash",
      "mazeRows": [
        "#########################",
        "#...#...........#.......#",
        "......#.#.###.#.###.#.#.#",
        "#.#.#...#...........#...#",
        "#.#.#######.####.####.###",
        "#.#.#...#...........#.#.#",
        "#.#.#.###########.#.#.#.#",
        "#...#.#.........#.#...#.#",
        "#.###.#.###...###.#.###.#",
        "#.#.#...#...#.#...#.....#",
        "#...#.###.###.###.#.###.#",
        "#.#.#.....#.....#...#...#",
        "#.#.#.#.#############.###",
        "#.#...#...#...#.......#.#",
        "#.###.###.#.#.#.#######.#",
        "#.......#...#.#.......#.#",
        "#.#####.#.###.####.##.#.#",
        "#.....#.#...#.#.....#...#",
        "#.###.#.###.#.#.#.#####.#",
        "#.#...#...#.#.#.#.#.....#",
        "#.#######.###.#.###.#####",
        "#.#.....#...#.#.........#",
        "#.#.#######.#.#.#.#####.#",
        "#.............#.#......G#",
        "#########################"
      ],
      "updatedAt": "2026-03-23T12:36:17.375Z"
    },
    {
      "mapId": "maze-710854-34l8bd",
      "name": "Maze 710854",
      "mazeRows": [
        "#########################",
        "#.#######################",
        "........................#",
        "#######################.#",
        "#######################.#",
        "#######################.#",
        "#######################.#",
        "#######################.#",
        "#######################.#",
        "#######################.#",
        "#######################.#",
        "#######################.#",
        "#######################.#",
        "#######################.#",
        "#######################.#",
        "#######################.#",
        "#######################.#",
        "#######################.#",
        "#######################.#",
        "#######################.#",
        "#######################.#",
        "#######################.#",
        "#######################.#",
        "#######################G#",
        "#########################"
      ],
      "updatedAt": "2026-03-23T11:51:51.388Z"
    }
  ]
}